11111111111111111111111111111111
10000000000001000000000000000001
11111111100001000000000000000001
11111111100001000011110000000001
11111111100001000011110000000001
11111111100001000000000000000001
11111111100001000000000000000001
10000000000001000000000000000001
10000000000001000000000000000001
10000000000001000000000000000001
10000000000001000000000000000001
10000000000001000000000000000001
10000011111111100000000000000001
10000011111111100000000000000001
10000000000000000000000000000001
10000000000000000000000000000001
10000000000000000000000000000001
10000000000000000000000000000001
10000001100000000000000000000001
10000001100000000000000000000001
10000000000000000000000000000001
10000000000000000000000000000001
10000000000000000000000000000001
10000000000000000000000000000001
10000001111111111111111000000001
10000001111111111111111000000001
10000000000000000000000000000001
10000000000000000000000000000001
10000000000000000000000000000001
10000011111110000000000000000001
10000000000000000000000000000001
11111111111111111111111111111111
