1111111111111111111111111
1000000000000000000000001
1000000000000000000000001
1002222000000000000000001
1002222000000000000000001
1000000000000000000000001
1000000000000000000022201
1000222200000000000022201
1000222200000000000022201
1000222200000000000022201
1000000000000000000000001
1000000222222200000000001
1000000222222200000000001
1000000222222200000000001
1000000222222200000000001
1000000000000000000000001
1000000000000000000000001
1000000000000000000000001
1000000000000000000000001
1000000000000002222200001
1000000000000002222200001
1000000000000002222200001
1000000000000002222200001
1000000000000000000000001
1111111111111111111111111
